000000000000
011111111110
011211111110
011211111110
011211111110
011211131110
000000000000