99
99
0000000000000000000000000000000000000000000000000000000000000000000000000000000000000000000000000000
0111000000000000000000000000111111000000011111100011111110000000000000111111111111000000001000001110
0000000000001111111100000001111111000000111111000011111110000000000000111111111110000000000000000110
0000000000011111111111111111111111000000111111000011111110000000000000111111111100000000000000000110
0000000000011111111111111111111110000000111111000011111110000000000000011111111000000000000000000000
0000000000111111111111111111111110000000111111000001111100000000000000011111100000000000000000000000
0011111000011111111111111111111110000001111111000000111100000000000000000110000000011100000000110000
0011111000011111111111111111111100000000111110000000010000000000001110000000000000111110000000111000
0011110000000111111111111111110000000000011100000000000000000000011111000000000001111111000000011000
0000000000000000000000000000000000000000000000000000000000000000000000000000000010000000000000000000
0000000000000000000000000000000000000000000000000000000000000000111111100000111111111111100000000000
0000000000000000000000000000000000000000000000000000000000000001111111100000111111111111110000000000
0111111111111111111111111100000000000000000000000000000000000001111111100001111111111111110000000000
0111111111111111111111111111000000000000000000000000000000000011111111100001111111111111110000000000
0111111111111111111111111111110000000000000000000000010000000011111111110000011111111111100000000000
0111111111111111111111111111100000000000000000000000111000000011111111110000011111111100000000000000
0111111111111111111111111111000000000000000000000000111000000011111111111100001111110000000000000000
0111111111111111111000000000000001110000000000000000010000000011111111111110001111100000000000000000
0111111111111100000000000000001111110000000000000000000000000001111111111111001111000000000000000000
0111111111111000000000000000011111110000000000000000000000000000011111111111000000000000001100000000
0111111111110000000000000001111111100000000000000000000000000000011111111111000000000000111110000000
0111111111110000000000000111111111000000000000000000000000000000011111111111000000000011111110000000
0111111111100000000000011111111100000000000000000000000000000000011111111110000000000111111100000000
0111111111000000000000111111110000000000000000000000000000000000011111111100000000001111111000000000
0111111100000000000011111111100000000000000000000000011100000000001111110000000000000111000000000000
0111110000000000001111111110000000000000000000000001111110000000000111000000000000000000000000000000
0111100000000000111111111000000000000000000000000011111111000000000000000000001110000000000000000000
0110000000000011111111100000000000000000000000001111111111000000000000000000111110000000000000000000
0100000000001111111111000000000000000000000000011111111111100000000000000011111100000000000000000000
0000000000111111111100000000000000000000000001111111111111110000000000000111111000000000000011111000
0000000011111111110000000000000000000000000111111111111111110000000000001111110000000000000111111100
0100001111111111000000000000000000000000001111111111111111110000000000001111100000000000000111111110
0111111111111100000000000000000000000000111111111111111111110000000000000110000000000000000111111100
0111111111110000000000000000000000000111111111111111111111100000000000000000000000000000000111111100
0111111111100000000000000000000000011111111111111111111110000000000000000000000000000000000011110000
0111111111000000000000000000000000111111111111111111111100000000000000000000000000000000000000000000
0111111100000000000000000000000000111111111111111111111000000000000000000000000111110000000000000000
0000000000000000000000000000000001111111111111111111100000000000000000000000001111111000000000000000
0000000000000000000000000000000000111111111111111110000000000000000000000000001111111000000000000000
0000000000000000000000000000000000111111111111111000000000000000000000000000001111111000000000000010
0000000000000000000000001110000000011111111111100000000000000000000000000000000111110000000000000110
0000000000000000000000001111000000011111111111000000333333333000000000000000000011100000000000000110
0000000000000000000000001111100000001111111100000000333333333000000000000000000000000000000000000110
0000000000000000000000001111110000000111110000000000333333333000000000000000000000001111110000000010
0000000000000000111100000111110000000011000000000000333333333000000000000000000000001111111000000000
0100000000000000111100000111111000000000000000000000333333333000000000000000000000011111111100000000
0100000000000001111000000011111000000000000000000000333333333000000000000000000000111111111110000000
0100000000000011111000000011111000000000000000000000333333333000000000000000000000111111111110000000
0100000001111111110000000001111000000000000000000000333333333000000000000000000000111111111111000000
0000000111111111110000000000110000000000000000000000000000000000000000000000000000111111111111000000
0000000111111111110000000000000000000000000000000000000000000000000000000000000000011111111111000000
0000001111111111111000000000000000000000000000000000000000000000000000000000000000001111111110000000
0000001111111111111000000000000000000000000000000000000000000000000000000000000000001111111000000000
0000001111111111111100000000000000000000000000000000000000000000000000000000000000000111100000000000
0000001111111111111110000000000000000000000000000000000000000000000000000000000000000000000000000000
0000001111111111111110000000000000000000000000000000000000000000000000000000000000000000000000000000
0000000111111111111111000000000000000000000000000000000000000000000000000000000000000000000000000000
0000000111111111111110000000000000111000000000000000000000000000000000000000000000000000000000000000
0000000011111111111110000000000000111100000000000000000000000000000000000000000000000000000000000000
0000000011111111111000000001100000111110000000000000000000000000000000000000000000000000000000000000
0000000001111111100000001111111000011110000000000000000000000000000000000000000000000000000000000000
0000000001111110000000111111111000011111000000000000000000000000000000000000000000000000000000000000
0000000000111000000001111111111100001111000000000000000000000000000000000000000000000000000000000000
0000000000000000000011111111111100000111000000000000000000000000000000000000000000000000000000000000
0000000000000000001111111111111100000011000000000000000000000000000000000000000000000000000000000000
0000000000000000111111111111111000000001100000000000000000000000000000000000000000000000000000000000
0000000000000000111111111111110000000000111000000000000000000000000000000000000000000000000000000000
0000000000000001111111111111000000000000111100000000000000000000000000000000000000000000000000000000
0000000000000001111111111100000000000000111100000000000000000000000000000000000000000000000000000000
0000000000000000111111110000000111100000111110000000000000000000000000000000000000000000000000000000
0000000000000000111111000000011111110000011110000000000000000000000000000000000000000000000000000000
0000000000000000011110000000111111111000001110000000000000000000000000000000000000000000000000000000
0000000000000000000000000001111111111000000000000000000000000000000000000000000000000000000000000000
0000000000000000000000000001111111111100000000000000000000000000000000000000000000000000000000000000
0000000000000000000000000001111111111000000000000000000000000000000000000000000000000000000000000000
0000000000000000000000000001111111110000000000000000000000000000000000000000000000000000000000000000
0000000000000000000011100000111111100000000000000000000000000000000000000000000000000000000000000000
0000000000000000000111110000011110000000000000000000000000000000000000000000000000000000000000000000
0000000000000000000011111000001000000000000000000000000000000000000000000000000000000000000000000000
0000000000000000000011111000000000000000000011100000000000000000000000000000000000000000000000000000
0000000000000000000001111000000000000000000111110000000000000000000000000000000000000000000000000000
0000000000000000000000111000000000000000000111111000000000000000000000000000000000000000000000000000
0000000000000000000000010000000000000000000111111100000000000000000000000000000000000000000000000000
0000000000000000000000000000000000001110000011111100000000000000000000000000000000000000000000000000
0000000000000000000000000000000000111111000011111110000000000000000000000000000000000000000000000000
0000000000000000000000000000000011111111100001111110000000000000000000000000000000000000000000000000
0000000000000000000000000000001111111111100000111111000000000000000000000000000000000000000000000000
0000000000000000000000000000011111111111110000111111100000000000000000000000000000000000000000000000
0000000000000000000000000001111111111111110000011111100000000000000000000000000000000000000000000000
0000000000000000000000000011111111111111111000011111110000000000000000000000000000000000000000000000
0000000000000000000000000011111111111111111000001111110000000000000000000000000000000000000000000000
0000000001000000000000000011111111111111111100000111111000000000000000000000000000000000000000000000
0000000111110000000000000011111111111111111110000111111100000000000000000000000000000000000000000000
0000111111111000000000000001111111111111111110000011111100000000000000000000000000000000000000000110
0011111111111000000000000001111111111111111111000011111110000000000000000000000000000000000000001110
0111111111111100000000000000111111111111111111000001111110000000000000000000000000000000000000011110
0111111111111100000000000000111111111111111111100000111111000000000000000000000000000000000000111110
0111111111111110000000000000011111111111111111100000111111100000000000000000000000000000000000111110
0111111111111100000000000000001111111111111111100000011111000000000000000000000000000000000000011110
0000000000000000000000000000000000000000000000000000000000000000000000000000000000000000000000000000
